Running game in AI mode with algorithm: expendi_search 
n_explored_nodes: 2873 
goal state found: {'white': {}, 'black': {}} 
number of actions taken to achieve goal: 15 

action sequence: 
[is_boom, x_from, y_from, x_to, y_to, n_tokens], where x_to, y_to, n_tokens = -1 for boom action 
[0, 6, 6, 5, 6, 1] 
[1, 7, 6, -1, -1, -1] 
[0, 0, 4, 1, 4, 1] 
[0, 1, 4, 2, 4, 1] 
[0, 2, 4, 3, 4, 1] 
[0, 3, 4, 4, 4, 1] 
[0, 5, 6, 4, 6, 1] 
[0, 4, 4, 5, 4, 1] 
[0, 5, 4, 5, 3, 1] 
[1, 5, 3, -1, -1, -1] 
[0, 4, 6, 5, 6, 1] 
[0, 5, 6, 6, 6, 1] 
[0, 6, 6, 6, 5, 1] 
[0, 6, 5, 6, 4, 1] 
[1, 6, 4, -1, -1, -1] 
# 
#    ┌───┬───┬───┬───┬───┬───┬───┬───┐
#  7 │   │   │   │   │1-b│   │   │1-b│
#    ├───┼───┼───┼───┼───┼───┼───┼───┤
#  6 │   │   │   │1-b│   │   │1-w│1-w│
#    ├───┼───┼───┼───┼───┼───┼───┼───┤
#  5 │   │   │   │   │1-b│1-b│   │   │
#    ├───┼───┼───┼───┼───┼───┼───┼───┤
#  4 │1-w│   │   │   │   │   │   │   │
#    ├───┼───┼───┼───┼───┼───┼───┼───┤
#  3 │   │   │   │   │1-b│   │   │1-b│
#    ├───┼───┼───┼───┼───┼───┼───┼───┤
#  2 │   │   │   │   │   │   │   │   │
#    ├───┼───┼───┼───┼───┼───┼───┼───┤
#  1 │   │   │   │   │   │   │   │   │
#    ├───┼───┼───┼───┼───┼───┼───┼───┤
#  0 │   │   │   │   │   │   │   │   │
#    └───┴───┴───┴───┴───┴───┴───┴───┘
# y/x  0   1   2   3   4   5   6   7
# 
#    ┌───┬───┬───┬───┬───┬───┬───┬───┐
#  7 │   │   │   │   │1-b│   │   │1-b│
#    ├───┼───┼───┼───┼───┼───┼───┼───┤
#  6 │   │   │   │1-b│   │1-w│   │1-w│
#    ├───┼───┼───┼───┼───┼───┼───┼───┤
#  5 │   │   │   │   │1-b│1-b│   │   │
#    ├───┼───┼───┼───┼───┼───┼───┼───┤
#  4 │1-w│   │   │   │   │   │   │   │
#    ├───┼───┼───┼───┼───┼───┼───┼───┤
#  3 │   │   │   │   │1-b│   │   │1-b│
#    ├───┼───┼───┼───┼───┼───┼───┼───┤
#  2 │   │   │   │   │   │   │   │   │
#    ├───┼───┼───┼───┼───┼───┼───┼───┤
#  1 │   │   │   │   │   │   │   │   │
#    ├───┼───┼───┼───┼───┼───┼───┼───┤
#  0 │   │   │   │   │   │   │   │   │
#    └───┴───┴───┴───┴───┴───┴───┴───┘
# y/x  0   1   2   3   4   5   6   7
# 
#    ┌───┬───┬───┬───┬───┬───┬───┬───┐
#  7 │   │   │   │   │1-b│   │   │   │
#    ├───┼───┼───┼───┼───┼───┼───┼───┤
#  6 │   │   │   │1-b│   │1-w│   │   │
#    ├───┼───┼───┼───┼───┼───┼───┼───┤
#  5 │   │   │   │   │1-b│1-b│   │   │
#    ├───┼───┼───┼───┼───┼───┼───┼───┤
#  4 │1-w│   │   │   │   │   │   │   │
#    ├───┼───┼───┼───┼───┼───┼───┼───┤
#  3 │   │   │   │   │1-b│   │   │1-b│
#    ├───┼───┼───┼───┼───┼───┼───┼───┤
#  2 │   │   │   │   │   │   │   │   │
#    ├───┼───┼───┼───┼───┼───┼───┼───┤
#  1 │   │   │   │   │   │   │   │   │
#    ├───┼───┼───┼───┼───┼───┼───┼───┤
#  0 │   │   │   │   │   │   │   │   │
#    └───┴───┴───┴───┴───┴───┴───┴───┘
# y/x  0   1   2   3   4   5   6   7
# 
#    ┌───┬───┬───┬───┬───┬───┬───┬───┐
#  7 │   │   │   │   │1-b│   │   │   │
#    ├───┼───┼───┼───┼───┼───┼───┼───┤
#  6 │   │   │   │1-b│   │1-w│   │   │
#    ├───┼───┼───┼───┼───┼───┼───┼───┤
#  5 │   │   │   │   │1-b│1-b│   │   │
#    ├───┼───┼───┼───┼───┼───┼───┼───┤
#  4 │   │1-w│   │   │   │   │   │   │
#    ├───┼───┼───┼───┼───┼───┼───┼───┤
#  3 │   │   │   │   │1-b│   │   │1-b│
#    ├───┼───┼───┼───┼───┼───┼───┼───┤
#  2 │   │   │   │   │   │   │   │   │
#    ├───┼───┼───┼───┼───┼───┼───┼───┤
#  1 │   │   │   │   │   │   │   │   │
#    ├───┼───┼───┼───┼───┼───┼───┼───┤
#  0 │   │   │   │   │   │   │   │   │
#    └───┴───┴───┴───┴───┴───┴───┴───┘
# y/x  0   1   2   3   4   5   6   7
# 
#    ┌───┬───┬───┬───┬───┬───┬───┬───┐
#  7 │   │   │   │   │1-b│   │   │   │
#    ├───┼───┼───┼───┼───┼───┼───┼───┤
#  6 │   │   │   │1-b│   │1-w│   │   │
#    ├───┼───┼───┼───┼───┼───┼───┼───┤
#  5 │   │   │   │   │1-b│1-b│   │   │
#    ├───┼───┼───┼───┼───┼───┼───┼───┤
#  4 │   │   │1-w│   │   │   │   │   │
#    ├───┼───┼───┼───┼───┼───┼───┼───┤
#  3 │   │   │   │   │1-b│   │   │1-b│
#    ├───┼───┼───┼───┼───┼───┼───┼───┤
#  2 │   │   │   │   │   │   │   │   │
#    ├───┼───┼───┼───┼───┼───┼───┼───┤
#  1 │   │   │   │   │   │   │   │   │
#    ├───┼───┼───┼───┼───┼───┼───┼───┤
#  0 │   │   │   │   │   │   │   │   │
#    └───┴───┴───┴───┴───┴───┴───┴───┘
# y/x  0   1   2   3   4   5   6   7
# 
#    ┌───┬───┬───┬───┬───┬───┬───┬───┐
#  7 │   │   │   │   │1-b│   │   │   │
#    ├───┼───┼───┼───┼───┼───┼───┼───┤
#  6 │   │   │   │1-b│   │1-w│   │   │
#    ├───┼───┼───┼───┼───┼───┼───┼───┤
#  5 │   │   │   │   │1-b│1-b│   │   │
#    ├───┼───┼───┼───┼───┼───┼───┼───┤
#  4 │   │   │   │1-w│   │   │   │   │
#    ├───┼───┼───┼───┼───┼───┼───┼───┤
#  3 │   │   │   │   │1-b│   │   │1-b│
#    ├───┼───┼───┼───┼───┼───┼───┼───┤
#  2 │   │   │   │   │   │   │   │   │
#    ├───┼───┼───┼───┼───┼───┼───┼───┤
#  1 │   │   │   │   │   │   │   │   │
#    ├───┼───┼───┼───┼───┼───┼───┼───┤
#  0 │   │   │   │   │   │   │   │   │
#    └───┴───┴───┴───┴───┴───┴───┴───┘
# y/x  0   1   2   3   4   5   6   7
# 
#    ┌───┬───┬───┬───┬───┬───┬───┬───┐
#  7 │   │   │   │   │1-b│   │   │   │
#    ├───┼───┼───┼───┼───┼───┼───┼───┤
#  6 │   │   │   │1-b│   │1-w│   │   │
#    ├───┼───┼───┼───┼───┼───┼───┼───┤
#  5 │   │   │   │   │1-b│1-b│   │   │
#    ├───┼───┼───┼───┼───┼───┼───┼───┤
#  4 │   │   │   │   │1-w│   │   │   │
#    ├───┼───┼───┼───┼───┼───┼───┼───┤
#  3 │   │   │   │   │1-b│   │   │1-b│
#    ├───┼───┼───┼───┼───┼───┼───┼───┤
#  2 │   │   │   │   │   │   │   │   │
#    ├───┼───┼───┼───┼───┼───┼───┼───┤
#  1 │   │   │   │   │   │   │   │   │
#    ├───┼───┼───┼───┼───┼───┼───┼───┤
#  0 │   │   │   │   │   │   │   │   │
#    └───┴───┴───┴───┴───┴───┴───┴───┘
# y/x  0   1   2   3   4   5   6   7
# 
#    ┌───┬───┬───┬───┬───┬───┬───┬───┐
#  7 │   │   │   │   │1-b│   │   │   │
#    ├───┼───┼───┼───┼───┼───┼───┼───┤
#  6 │   │   │   │1-b│1-w│   │   │   │
#    ├───┼───┼───┼───┼───┼───┼───┼───┤
#  5 │   │   │   │   │1-b│1-b│   │   │
#    ├───┼───┼───┼───┼───┼───┼───┼───┤
#  4 │   │   │   │   │1-w│   │   │   │
#    ├───┼───┼───┼───┼───┼───┼───┼───┤
#  3 │   │   │   │   │1-b│   │   │1-b│
#    ├───┼───┼───┼───┼───┼───┼───┼───┤
#  2 │   │   │   │   │   │   │   │   │
#    ├───┼───┼───┼───┼───┼───┼───┼───┤
#  1 │   │   │   │   │   │   │   │   │
#    ├───┼───┼───┼───┼───┼───┼───┼───┤
#  0 │   │   │   │   │   │   │   │   │
#    └───┴───┴───┴───┴───┴───┴───┴───┘
# y/x  0   1   2   3   4   5   6   7
# 
#    ┌───┬───┬───┬───┬───┬───┬───┬───┐
#  7 │   │   │   │   │1-b│   │   │   │
#    ├───┼───┼───┼───┼───┼───┼───┼───┤
#  6 │   │   │   │1-b│1-w│   │   │   │
#    ├───┼───┼───┼───┼───┼───┼───┼───┤
#  5 │   │   │   │   │1-b│1-b│   │   │
#    ├───┼───┼───┼───┼───┼───┼───┼───┤
#  4 │   │   │   │   │   │1-w│   │   │
#    ├───┼───┼───┼───┼───┼───┼───┼───┤
#  3 │   │   │   │   │1-b│   │   │1-b│
#    ├───┼───┼───┼───┼───┼───┼───┼───┤
#  2 │   │   │   │   │   │   │   │   │
#    ├───┼───┼───┼───┼───┼───┼───┼───┤
#  1 │   │   │   │   │   │   │   │   │
#    ├───┼───┼───┼───┼───┼───┼───┼───┤
#  0 │   │   │   │   │   │   │   │   │
#    └───┴───┴───┴───┴───┴───┴───┴───┘
# y/x  0   1   2   3   4   5   6   7
# 
#    ┌───┬───┬───┬───┬───┬───┬───┬───┐
#  7 │   │   │   │   │1-b│   │   │   │
#    ├───┼───┼───┼───┼───┼───┼───┼───┤
#  6 │   │   │   │1-b│1-w│   │   │   │
#    ├───┼───┼───┼───┼───┼───┼───┼───┤
#  5 │   │   │   │   │1-b│1-b│   │   │
#    ├───┼───┼───┼───┼───┼───┼───┼───┤
#  4 │   │   │   │   │   │   │   │   │
#    ├───┼───┼───┼───┼───┼───┼───┼───┤
#  3 │   │   │   │   │1-b│1-w│   │1-b│
#    ├───┼───┼───┼───┼───┼───┼───┼───┤
#  2 │   │   │   │   │   │   │   │   │
#    ├───┼───┼───┼───┼───┼───┼───┼───┤
#  1 │   │   │   │   │   │   │   │   │
#    ├───┼───┼───┼───┼───┼───┼───┼───┤
#  0 │   │   │   │   │   │   │   │   │
#    └───┴───┴───┴───┴───┴───┴───┴───┘
# y/x  0   1   2   3   4   5   6   7
# 
#    ┌───┬───┬───┬───┬───┬───┬───┬───┐
#  7 │   │   │   │   │1-b│   │   │   │
#    ├───┼───┼───┼───┼───┼───┼───┼───┤
#  6 │   │   │   │1-b│1-w│   │   │   │
#    ├───┼───┼───┼───┼───┼───┼───┼───┤
#  5 │   │   │   │   │1-b│1-b│   │   │
#    ├───┼───┼───┼───┼───┼───┼───┼───┤
#  4 │   │   │   │   │   │   │   │   │
#    ├───┼───┼───┼───┼───┼───┼───┼───┤
#  3 │   │   │   │   │   │   │   │1-b│
#    ├───┼───┼───┼───┼───┼───┼───┼───┤
#  2 │   │   │   │   │   │   │   │   │
#    ├───┼───┼───┼───┼───┼───┼───┼───┤
#  1 │   │   │   │   │   │   │   │   │
#    ├───┼───┼───┼───┼───┼───┼───┼───┤
#  0 │   │   │   │   │   │   │   │   │
#    └───┴───┴───┴───┴───┴───┴───┴───┘
# y/x  0   1   2   3   4   5   6   7
# 
#    ┌───┬───┬───┬───┬───┬───┬───┬───┐
#  7 │   │   │   │   │1-b│   │   │   │
#    ├───┼───┼───┼───┼───┼───┼───┼───┤
#  6 │   │   │   │1-b│   │1-w│   │   │
#    ├───┼───┼───┼───┼───┼───┼───┼───┤
#  5 │   │   │   │   │1-b│1-b│   │   │
#    ├───┼───┼───┼───┼───┼───┼───┼───┤
#  4 │   │   │   │   │   │   │   │   │
#    ├───┼───┼───┼───┼───┼───┼───┼───┤
#  3 │   │   │   │   │   │   │   │1-b│
#    ├───┼───┼───┼───┼───┼───┼───┼───┤
#  2 │   │   │   │   │   │   │   │   │
#    ├───┼───┼───┼───┼───┼───┼───┼───┤
#  1 │   │   │   │   │   │   │   │   │
#    ├───┼───┼───┼───┼───┼───┼───┼───┤
#  0 │   │   │   │   │   │   │   │   │
#    └───┴───┴───┴───┴───┴───┴───┴───┘
# y/x  0   1   2   3   4   5   6   7
# 
#    ┌───┬───┬───┬───┬───┬───┬───┬───┐
#  7 │   │   │   │   │1-b│   │   │   │
#    ├───┼───┼───┼───┼───┼───┼───┼───┤
#  6 │   │   │   │1-b│   │   │1-w│   │
#    ├───┼───┼───┼───┼───┼───┼───┼───┤
#  5 │   │   │   │   │1-b│1-b│   │   │
#    ├───┼───┼───┼───┼───┼───┼───┼───┤
#  4 │   │   │   │   │   │   │   │   │
#    ├───┼───┼───┼───┼───┼───┼───┼───┤
#  3 │   │   │   │   │   │   │   │1-b│
#    ├───┼───┼───┼───┼───┼───┼───┼───┤
#  2 │   │   │   │   │   │   │   │   │
#    ├───┼───┼───┼───┼───┼───┼───┼───┤
#  1 │   │   │   │   │   │   │   │   │
#    ├───┼───┼───┼───┼───┼───┼───┼───┤
#  0 │   │   │   │   │   │   │   │   │
#    └───┴───┴───┴───┴───┴───┴───┴───┘
# y/x  0   1   2   3   4   5   6   7
# 
#    ┌───┬───┬───┬───┬───┬───┬───┬───┐
#  7 │   │   │   │   │1-b│   │   │   │
#    ├───┼───┼───┼───┼───┼───┼───┼───┤
#  6 │   │   │   │1-b│   │   │   │   │
#    ├───┼───┼───┼───┼───┼───┼───┼───┤
#  5 │   │   │   │   │1-b│1-b│1-w│   │
#    ├───┼───┼───┼───┼───┼───┼───┼───┤
#  4 │   │   │   │   │   │   │   │   │
#    ├───┼───┼───┼───┼───┼───┼───┼───┤
#  3 │   │   │   │   │   │   │   │1-b│
#    ├───┼───┼───┼───┼───┼───┼───┼───┤
#  2 │   │   │   │   │   │   │   │   │
#    ├───┼───┼───┼───┼───┼───┼───┼───┤
#  1 │   │   │   │   │   │   │   │   │
#    ├───┼───┼───┼───┼───┼───┼───┼───┤
#  0 │   │   │   │   │   │   │   │   │
#    └───┴───┴───┴───┴───┴───┴───┴───┘
# y/x  0   1   2   3   4   5   6   7
# 
#    ┌───┬───┬───┬───┬───┬───┬───┬───┐
#  7 │   │   │   │   │1-b│   │   │   │
#    ├───┼───┼───┼───┼───┼───┼───┼───┤
#  6 │   │   │   │1-b│   │   │   │   │
#    ├───┼───┼───┼───┼───┼───┼───┼───┤
#  5 │   │   │   │   │1-b│1-b│   │   │
#    ├───┼───┼───┼───┼───┼───┼───┼───┤
#  4 │   │   │   │   │   │   │1-w│   │
#    ├───┼───┼───┼───┼───┼───┼───┼───┤
#  3 │   │   │   │   │   │   │   │1-b│
#    ├───┼───┼───┼───┼───┼───┼───┼───┤
#  2 │   │   │   │   │   │   │   │   │
#    ├───┼───┼───┼───┼───┼───┼───┼───┤
#  1 │   │   │   │   │   │   │   │   │
#    ├───┼───┼───┼───┼───┼───┼───┼───┤
#  0 │   │   │   │   │   │   │   │   │
#    └───┴───┴───┴───┴───┴───┴───┴───┘
# y/x  0   1   2   3   4   5   6   7
# 
#    ┌───┬───┬───┬───┬───┬───┬───┬───┐
#  7 │   │   │   │   │   │   │   │   │
#    ├───┼───┼───┼───┼───┼───┼───┼───┤
#  6 │   │   │   │   │   │   │   │   │
#    ├───┼───┼───┼───┼───┼───┼───┼───┤
#  5 │   │   │   │   │   │   │   │   │
#    ├───┼───┼───┼───┼───┼───┼───┼───┤
#  4 │   │   │   │   │   │   │   │   │
#    ├───┼───┼───┼───┼───┼───┼───┼───┤
#  3 │   │   │   │   │   │   │   │   │
#    ├───┼───┼───┼───┼───┼───┼───┼───┤
#  2 │   │   │   │   │   │   │   │   │
#    ├───┼───┼───┼───┼───┼───┼───┼───┤
#  1 │   │   │   │   │   │   │   │   │
#    ├───┼───┼───┼───┼───┼───┼───┼───┤
#  0 │   │   │   │   │   │   │   │   │
#    └───┴───┴───┴───┴───┴───┴───┴───┘
# y/x  0   1   2   3   4   5   6   7
White wins: no stacks left on board