n_explored_nodes: 125 
goal state found: {'white': {}, 'black': {}} 
number of actions taken to achieve goal: 4 

action sequence: 
[is_boom, x_from, y_from, x_to, y_to, n_tokens], where x_to, y_to, n_tokens = -1 for boom action 
[0, 1, 3, 2, 3, 1] 
[0, 3, 5, 4, 5, 1] 
[0, 2, 3, 3, 3, 1] 
[1, 4, 5, -1, -1, -1] 
# 
#    ┌───┬───┬───┬───┬───┬───┬───┬───┐
#  7 │   │   │   │   │   │   │1-b│   │
#    ├───┼───┼───┼───┼───┼───┼───┼───┤
#  6 │   │   │   │   │   │1-b│   │   │
#    ├───┼───┼───┼───┼───┼───┼───┼───┤
#  5 │   │   │1-b│1-w│   │   │   │   │
#    ├───┼───┼───┼───┼───┼───┼───┼───┤
#  4 │   │   │   │1-b│   │   │   │   │
#    ├───┼───┼───┼───┼───┼───┼───┼───┤
#  3 │   │1-w│   │   │   │   │   │   │
#    ├───┼───┼───┼───┼───┼───┼───┼───┤
#  2 │   │   │   │   │1-b│2-b│1-b│   │
#    ├───┼───┼───┼───┼───┼───┼───┼───┤
#  1 │   │   │   │   │   │   │   │   │
#    ├───┼───┼───┼───┼───┼───┼───┼───┤
#  0 │   │   │   │   │   │   │   │   │
#    └───┴───┴───┴───┴───┴───┴───┴───┘
# y/x  0   1   2   3   4   5   6   7
# 
#    ┌───┬───┬───┬───┬───┬───┬───┬───┐
#  7 │   │   │   │   │   │   │1-b│   │
#    ├───┼───┼───┼───┼───┼───┼───┼───┤
#  6 │   │   │   │   │   │1-b│   │   │
#    ├───┼───┼───┼───┼───┼───┼───┼───┤
#  5 │   │   │1-b│1-w│   │   │   │   │
#    ├───┼───┼───┼───┼───┼───┼───┼───┤
#  4 │   │   │   │1-b│   │   │   │   │
#    ├───┼───┼───┼───┼───┼───┼───┼───┤
#  3 │   │   │1-w│   │   │   │   │   │
#    ├───┼───┼───┼───┼───┼───┼───┼───┤
#  2 │   │   │   │   │1-b│2-b│1-b│   │
#    ├───┼───┼───┼───┼───┼───┼───┼───┤
#  1 │   │   │   │   │   │   │   │   │
#    ├───┼───┼───┼───┼───┼───┼───┼───┤
#  0 │   │   │   │   │   │   │   │   │
#    └───┴───┴───┴───┴───┴───┴───┴───┘
# y/x  0   1   2   3   4   5   6   7
# 
#    ┌───┬───┬───┬───┬───┬───┬───┬───┐
#  7 │   │   │   │   │   │   │1-b│   │
#    ├───┼───┼───┼───┼───┼───┼───┼───┤
#  6 │   │   │   │   │   │1-b│   │   │
#    ├───┼───┼───┼───┼───┼───┼───┼───┤
#  5 │   │   │1-b│   │1-w│   │   │   │
#    ├───┼───┼───┼───┼───┼───┼───┼───┤
#  4 │   │   │   │1-b│   │   │   │   │
#    ├───┼───┼───┼───┼───┼───┼───┼───┤
#  3 │   │   │1-w│   │   │   │   │   │
#    ├───┼───┼───┼───┼───┼───┼───┼───┤
#  2 │   │   │   │   │1-b│2-b│1-b│   │
#    ├───┼───┼───┼───┼───┼───┼───┼───┤
#  1 │   │   │   │   │   │   │   │   │
#    ├───┼───┼───┼───┼───┼───┼───┼───┤
#  0 │   │   │   │   │   │   │   │   │
#    └───┴───┴───┴───┴───┴───┴───┴───┘
# y/x  0   1   2   3   4   5   6   7
# 
#    ┌───┬───┬───┬───┬───┬───┬───┬───┐
#  7 │   │   │   │   │   │   │1-b│   │
#    ├───┼───┼───┼───┼───┼───┼───┼───┤
#  6 │   │   │   │   │   │1-b│   │   │
#    ├───┼───┼───┼───┼───┼───┼───┼───┤
#  5 │   │   │1-b│   │1-w│   │   │   │
#    ├───┼───┼───┼───┼───┼───┼───┼───┤
#  4 │   │   │   │1-b│   │   │   │   │
#    ├───┼───┼───┼───┼───┼───┼───┼───┤
#  3 │   │   │   │1-w│   │   │   │   │
#    ├───┼───┼───┼───┼───┼───┼───┼───┤
#  2 │   │   │   │   │1-b│2-b│1-b│   │
#    ├───┼───┼───┼───┼───┼───┼───┼───┤
#  1 │   │   │   │   │   │   │   │   │
#    ├───┼───┼───┼───┼───┼───┼───┼───┤
#  0 │   │   │   │   │   │   │   │   │
#    └───┴───┴───┴───┴───┴───┴───┴───┘
# y/x  0   1   2   3   4   5   6   7
# 
#    ┌───┬───┬───┬───┬───┬───┬───┬───┐
#  7 │   │   │   │   │   │   │   │   │
#    ├───┼───┼───┼───┼───┼───┼───┼───┤
#  6 │   │   │   │   │   │   │   │   │
#    ├───┼───┼───┼───┼───┼───┼───┼───┤
#  5 │   │   │   │   │   │   │   │   │
#    ├───┼───┼───┼───┼───┼───┼───┼───┤
#  4 │   │   │   │   │   │   │   │   │
#    ├───┼───┼───┼───┼───┼───┼───┼───┤
#  3 │   │   │   │   │   │   │   │   │
#    ├───┼───┼───┼───┼───┼───┼───┼───┤
#  2 │   │   │   │   │   │   │   │   │
#    ├───┼───┼───┼───┼───┼───┼───┼───┤
#  1 │   │   │   │   │   │   │   │   │
#    ├───┼───┼───┼───┼───┼───┼───┼───┤
#  0 │   │   │   │   │   │   │   │   │
#    └───┴───┴───┴───┴───┴───┴───┴───┘
# y/x  0   1   2   3   4   5   6   7
White wins: no stacks left on board