Running game in AI mode with algorithm: depth_first_search 
n_explored_nodes: 28 
goal state found: {'white': {}, 'black': {}} 
number of actions taken to achieve goal: 18 

action sequence: 
[is_boom, x_from, y_from, x_to, y_to, n_tokens], where x_to, y_to, n_tokens = -1 for boom action 
[0, 1, 4, 0, 4, 1] 
[0, 0, 4, 0, 3, 1] 
[0, 0, 3, 0, 2, 1] 
[0, 0, 2, 1, 2, 1] 
[0, 1, 2, 2, 2, 1] 
[0, 2, 2, 3, 2, 1] 
[0, 3, 2, 4, 2, 1] 
[0, 4, 2, 5, 2, 1] 
[0, 5, 2, 6, 2, 1] 
[0, 6, 2, 7, 2, 1] 
[0, 7, 2, 7, 3, 1] 
[0, 7, 3, 7, 4, 1] 
[0, 7, 4, 6, 4, 1] 
[0, 6, 4, 5, 4, 1] 
[0, 5, 4, 4, 4, 1] 
[0, 4, 4, 3, 4, 1] 
[0, 3, 4, 3, 5, 1] 
[1, 3, 5, -1, -1, -1] 
# 
#    ┌───┬───┬───┬───┬───┬───┬───┬───┐
#  7 │   │   │   │   │   │   │   │   │
#    ├───┼───┼───┼───┼───┼───┼───┼───┤
#  6 │   │   │   │   │1-b│   │   │   │
#    ├───┼───┼───┼───┼───┼───┼───┼───┤
#  5 │   │   │   │   │   │   │   │   │
#    ├───┼───┼───┼───┼───┼───┼───┼───┤
#  4 │   │1-w│   │   │   │   │   │   │
#    ├───┼───┼───┼───┼───┼───┼───┼───┤
#  3 │   │   │   │   │   │   │   │   │
#    ├───┼───┼───┼───┼───┼───┼───┼───┤
#  2 │   │   │   │   │   │   │   │   │
#    ├───┼───┼───┼───┼───┼───┼───┼───┤
#  1 │   │   │   │   │   │   │   │   │
#    ├───┼───┼───┼───┼───┼───┼───┼───┤
#  0 │   │   │   │   │   │   │   │   │
#    └───┴───┴───┴───┴───┴───┴───┴───┘
# y/x  0   1   2   3   4   5   6   7
# 
#    ┌───┬───┬───┬───┬───┬───┬───┬───┐
#  7 │   │   │   │   │   │   │   │   │
#    ├───┼───┼───┼───┼───┼───┼───┼───┤
#  6 │   │   │   │   │1-b│   │   │   │
#    ├───┼───┼───┼───┼───┼───┼───┼───┤
#  5 │   │   │   │   │   │   │   │   │
#    ├───┼───┼───┼───┼───┼───┼───┼───┤
#  4 │1-w│   │   │   │   │   │   │   │
#    ├───┼───┼───┼───┼───┼───┼───┼───┤
#  3 │   │   │   │   │   │   │   │   │
#    ├───┼───┼───┼───┼───┼───┼───┼───┤
#  2 │   │   │   │   │   │   │   │   │
#    ├───┼───┼───┼───┼───┼───┼───┼───┤
#  1 │   │   │   │   │   │   │   │   │
#    ├───┼───┼───┼───┼───┼───┼───┼───┤
#  0 │   │   │   │   │   │   │   │   │
#    └───┴───┴───┴───┴───┴───┴───┴───┘
# y/x  0   1   2   3   4   5   6   7
# 
#    ┌───┬───┬───┬───┬───┬───┬───┬───┐
#  7 │   │   │   │   │   │   │   │   │
#    ├───┼───┼───┼───┼───┼───┼───┼───┤
#  6 │   │   │   │   │1-b│   │   │   │
#    ├───┼───┼───┼───┼───┼───┼───┼───┤
#  5 │   │   │   │   │   │   │   │   │
#    ├───┼───┼───┼───┼───┼───┼───┼───┤
#  4 │   │   │   │   │   │   │   │   │
#    ├───┼───┼───┼───┼───┼───┼───┼───┤
#  3 │1-w│   │   │   │   │   │   │   │
#    ├───┼───┼───┼───┼───┼───┼───┼───┤
#  2 │   │   │   │   │   │   │   │   │
#    ├───┼───┼───┼───┼───┼───┼───┼───┤
#  1 │   │   │   │   │   │   │   │   │
#    ├───┼───┼───┼───┼───┼───┼───┼───┤
#  0 │   │   │   │   │   │   │   │   │
#    └───┴───┴───┴───┴───┴───┴───┴───┘
# y/x  0   1   2   3   4   5   6   7
# 
#    ┌───┬───┬───┬───┬───┬───┬───┬───┐
#  7 │   │   │   │   │   │   │   │   │
#    ├───┼───┼───┼───┼───┼───┼───┼───┤
#  6 │   │   │   │   │1-b│   │   │   │
#    ├───┼───┼───┼───┼───┼───┼───┼───┤
#  5 │   │   │   │   │   │   │   │   │
#    ├───┼───┼───┼───┼───┼───┼───┼───┤
#  4 │   │   │   │   │   │   │   │   │
#    ├───┼───┼───┼───┼───┼───┼───┼───┤
#  3 │   │   │   │   │   │   │   │   │
#    ├───┼───┼───┼───┼───┼───┼───┼───┤
#  2 │1-w│   │   │   │   │   │   │   │
#    ├───┼───┼───┼───┼───┼───┼───┼───┤
#  1 │   │   │   │   │   │   │   │   │
#    ├───┼───┼───┼───┼───┼───┼───┼───┤
#  0 │   │   │   │   │   │   │   │   │
#    └───┴───┴───┴───┴───┴───┴───┴───┘
# y/x  0   1   2   3   4   5   6   7
# 
#    ┌───┬───┬───┬───┬───┬───┬───┬───┐
#  7 │   │   │   │   │   │   │   │   │
#    ├───┼───┼───┼───┼───┼───┼───┼───┤
#  6 │   │   │   │   │1-b│   │   │   │
#    ├───┼───┼───┼───┼───┼───┼───┼───┤
#  5 │   │   │   │   │   │   │   │   │
#    ├───┼───┼───┼───┼───┼───┼───┼───┤
#  4 │   │   │   │   │   │   │   │   │
#    ├───┼───┼───┼───┼───┼───┼───┼───┤
#  3 │   │   │   │   │   │   │   │   │
#    ├───┼───┼───┼───┼───┼───┼───┼───┤
#  2 │   │1-w│   │   │   │   │   │   │
#    ├───┼───┼───┼───┼───┼───┼───┼───┤
#  1 │   │   │   │   │   │   │   │   │
#    ├───┼───┼───┼───┼───┼───┼───┼───┤
#  0 │   │   │   │   │   │   │   │   │
#    └───┴───┴───┴───┴───┴───┴───┴───┘
# y/x  0   1   2   3   4   5   6   7
# 
#    ┌───┬───┬───┬───┬───┬───┬───┬───┐
#  7 │   │   │   │   │   │   │   │   │
#    ├───┼───┼───┼───┼───┼───┼───┼───┤
#  6 │   │   │   │   │1-b│   │   │   │
#    ├───┼───┼───┼───┼───┼───┼───┼───┤
#  5 │   │   │   │   │   │   │   │   │
#    ├───┼───┼───┼───┼───┼───┼───┼───┤
#  4 │   │   │   │   │   │   │   │   │
#    ├───┼───┼───┼───┼───┼───┼───┼───┤
#  3 │   │   │   │   │   │   │   │   │
#    ├───┼───┼───┼───┼───┼───┼───┼───┤
#  2 │   │   │1-w│   │   │   │   │   │
#    ├───┼───┼───┼───┼───┼───┼───┼───┤
#  1 │   │   │   │   │   │   │   │   │
#    ├───┼───┼───┼───┼───┼───┼───┼───┤
#  0 │   │   │   │   │   │   │   │   │
#    └───┴───┴───┴───┴───┴───┴───┴───┘
# y/x  0   1   2   3   4   5   6   7
# 
#    ┌───┬───┬───┬───┬───┬───┬───┬───┐
#  7 │   │   │   │   │   │   │   │   │
#    ├───┼───┼───┼───┼───┼───┼───┼───┤
#  6 │   │   │   │   │1-b│   │   │   │
#    ├───┼───┼───┼───┼───┼───┼───┼───┤
#  5 │   │   │   │   │   │   │   │   │
#    ├───┼───┼───┼───┼───┼───┼───┼───┤
#  4 │   │   │   │   │   │   │   │   │
#    ├───┼───┼───┼───┼───┼───┼───┼───┤
#  3 │   │   │   │   │   │   │   │   │
#    ├───┼───┼───┼───┼───┼───┼───┼───┤
#  2 │   │   │   │1-w│   │   │   │   │
#    ├───┼───┼───┼───┼───┼───┼───┼───┤
#  1 │   │   │   │   │   │   │   │   │
#    ├───┼───┼───┼───┼───┼───┼───┼───┤
#  0 │   │   │   │   │   │   │   │   │
#    └───┴───┴───┴───┴───┴───┴───┴───┘
# y/x  0   1   2   3   4   5   6   7
# 
#    ┌───┬───┬───┬───┬───┬───┬───┬───┐
#  7 │   │   │   │   │   │   │   │   │
#    ├───┼───┼───┼───┼───┼───┼───┼───┤
#  6 │   │   │   │   │1-b│   │   │   │
#    ├───┼───┼───┼───┼───┼───┼───┼───┤
#  5 │   │   │   │   │   │   │   │   │
#    ├───┼───┼───┼───┼───┼───┼───┼───┤
#  4 │   │   │   │   │   │   │   │   │
#    ├───┼───┼───┼───┼───┼───┼───┼───┤
#  3 │   │   │   │   │   │   │   │   │
#    ├───┼───┼───┼───┼───┼───┼───┼───┤
#  2 │   │   │   │   │1-w│   │   │   │
#    ├───┼───┼───┼───┼───┼───┼───┼───┤
#  1 │   │   │   │   │   │   │   │   │
#    ├───┼───┼───┼───┼───┼───┼───┼───┤
#  0 │   │   │   │   │   │   │   │   │
#    └───┴───┴───┴───┴───┴───┴───┴───┘
# y/x  0   1   2   3   4   5   6   7
# 
#    ┌───┬───┬───┬───┬───┬───┬───┬───┐
#  7 │   │   │   │   │   │   │   │   │
#    ├───┼───┼───┼───┼───┼───┼───┼───┤
#  6 │   │   │   │   │1-b│   │   │   │
#    ├───┼───┼───┼───┼───┼───┼───┼───┤
#  5 │   │   │   │   │   │   │   │   │
#    ├───┼───┼───┼───┼───┼───┼───┼───┤
#  4 │   │   │   │   │   │   │   │   │
#    ├───┼───┼───┼───┼───┼───┼───┼───┤
#  3 │   │   │   │   │   │   │   │   │
#    ├───┼───┼───┼───┼───┼───┼───┼───┤
#  2 │   │   │   │   │   │1-w│   │   │
#    ├───┼───┼───┼───┼───┼───┼───┼───┤
#  1 │   │   │   │   │   │   │   │   │
#    ├───┼───┼───┼───┼───┼───┼───┼───┤
#  0 │   │   │   │   │   │   │   │   │
#    └───┴───┴───┴───┴───┴───┴───┴───┘
# y/x  0   1   2   3   4   5   6   7
# 
#    ┌───┬───┬───┬───┬───┬───┬───┬───┐
#  7 │   │   │   │   │   │   │   │   │
#    ├───┼───┼───┼───┼───┼───┼───┼───┤
#  6 │   │   │   │   │1-b│   │   │   │
#    ├───┼───┼───┼───┼───┼───┼───┼───┤
#  5 │   │   │   │   │   │   │   │   │
#    ├───┼───┼───┼───┼───┼───┼───┼───┤
#  4 │   │   │   │   │   │   │   │   │
#    ├───┼───┼───┼───┼───┼───┼───┼───┤
#  3 │   │   │   │   │   │   │   │   │
#    ├───┼───┼───┼───┼───┼───┼───┼───┤
#  2 │   │   │   │   │   │   │1-w│   │
#    ├───┼───┼───┼───┼───┼───┼───┼───┤
#  1 │   │   │   │   │   │   │   │   │
#    ├───┼───┼───┼───┼───┼───┼───┼───┤
#  0 │   │   │   │   │   │   │   │   │
#    └───┴───┴───┴───┴───┴───┴───┴───┘
# y/x  0   1   2   3   4   5   6   7
# 
#    ┌───┬───┬───┬───┬───┬───┬───┬───┐
#  7 │   │   │   │   │   │   │   │   │
#    ├───┼───┼───┼───┼───┼───┼───┼───┤
#  6 │   │   │   │   │1-b│   │   │   │
#    ├───┼───┼───┼───┼───┼───┼───┼───┤
#  5 │   │   │   │   │   │   │   │   │
#    ├───┼───┼───┼───┼───┼───┼───┼───┤
#  4 │   │   │   │   │   │   │   │   │
#    ├───┼───┼───┼───┼───┼───┼───┼───┤
#  3 │   │   │   │   │   │   │   │   │
#    ├───┼───┼───┼───┼───┼───┼───┼───┤
#  2 │   │   │   │   │   │   │   │1-w│
#    ├───┼───┼───┼───┼───┼───┼───┼───┤
#  1 │   │   │   │   │   │   │   │   │
#    ├───┼───┼───┼───┼───┼───┼───┼───┤
#  0 │   │   │   │   │   │   │   │   │
#    └───┴───┴───┴───┴───┴───┴───┴───┘
# y/x  0   1   2   3   4   5   6   7
# 
#    ┌───┬───┬───┬───┬───┬───┬───┬───┐
#  7 │   │   │   │   │   │   │   │   │
#    ├───┼───┼───┼───┼───┼───┼───┼───┤
#  6 │   │   │   │   │1-b│   │   │   │
#    ├───┼───┼───┼───┼───┼───┼───┼───┤
#  5 │   │   │   │   │   │   │   │   │
#    ├───┼───┼───┼───┼───┼───┼───┼───┤
#  4 │   │   │   │   │   │   │   │   │
#    ├───┼───┼───┼───┼───┼───┼───┼───┤
#  3 │   │   │   │   │   │   │   │1-w│
#    ├───┼───┼───┼───┼───┼───┼───┼───┤
#  2 │   │   │   │   │   │   │   │   │
#    ├───┼───┼───┼───┼───┼───┼───┼───┤
#  1 │   │   │   │   │   │   │   │   │
#    ├───┼───┼───┼───┼───┼───┼───┼───┤
#  0 │   │   │   │   │   │   │   │   │
#    └───┴───┴───┴───┴───┴───┴───┴───┘
# y/x  0   1   2   3   4   5   6   7
# 
#    ┌───┬───┬───┬───┬───┬───┬───┬───┐
#  7 │   │   │   │   │   │   │   │   │
#    ├───┼───┼───┼───┼───┼───┼───┼───┤
#  6 │   │   │   │   │1-b│   │   │   │
#    ├───┼───┼───┼───┼───┼───┼───┼───┤
#  5 │   │   │   │   │   │   │   │   │
#    ├───┼───┼───┼───┼───┼───┼───┼───┤
#  4 │   │   │   │   │   │   │   │1-w│
#    ├───┼───┼───┼───┼───┼───┼───┼───┤
#  3 │   │   │   │   │   │   │   │   │
#    ├───┼───┼───┼───┼───┼───┼───┼───┤
#  2 │   │   │   │   │   │   │   │   │
#    ├───┼───┼───┼───┼───┼───┼───┼───┤
#  1 │   │   │   │   │   │   │   │   │
#    ├───┼───┼───┼───┼───┼───┼───┼───┤
#  0 │   │   │   │   │   │   │   │   │
#    └───┴───┴───┴───┴───┴───┴───┴───┘
# y/x  0   1   2   3   4   5   6   7
# 
#    ┌───┬───┬───┬───┬───┬───┬───┬───┐
#  7 │   │   │   │   │   │   │   │   │
#    ├───┼───┼───┼───┼───┼───┼───┼───┤
#  6 │   │   │   │   │1-b│   │   │   │
#    ├───┼───┼───┼───┼───┼───┼───┼───┤
#  5 │   │   │   │   │   │   │   │   │
#    ├───┼───┼───┼───┼───┼───┼───┼───┤
#  4 │   │   │   │   │   │   │1-w│   │
#    ├───┼───┼───┼───┼───┼───┼───┼───┤
#  3 │   │   │   │   │   │   │   │   │
#    ├───┼───┼───┼───┼───┼───┼───┼───┤
#  2 │   │   │   │   │   │   │   │   │
#    ├───┼───┼───┼───┼───┼───┼───┼───┤
#  1 │   │   │   │   │   │   │   │   │
#    ├───┼───┼───┼───┼───┼───┼───┼───┤
#  0 │   │   │   │   │   │   │   │   │
#    └───┴───┴───┴───┴───┴───┴───┴───┘
# y/x  0   1   2   3   4   5   6   7
# 
#    ┌───┬───┬───┬───┬───┬───┬───┬───┐
#  7 │   │   │   │   │   │   │   │   │
#    ├───┼───┼───┼───┼───┼───┼───┼───┤
#  6 │   │   │   │   │1-b│   │   │   │
#    ├───┼───┼───┼───┼───┼───┼───┼───┤
#  5 │   │   │   │   │   │   │   │   │
#    ├───┼───┼───┼───┼───┼───┼───┼───┤
#  4 │   │   │   │   │   │1-w│   │   │
#    ├───┼───┼───┼───┼───┼───┼───┼───┤
#  3 │   │   │   │   │   │   │   │   │
#    ├───┼───┼───┼───┼───┼───┼───┼───┤
#  2 │   │   │   │   │   │   │   │   │
#    ├───┼───┼───┼───┼───┼───┼───┼───┤
#  1 │   │   │   │   │   │   │   │   │
#    ├───┼───┼───┼───┼───┼───┼───┼───┤
#  0 │   │   │   │   │   │   │   │   │
#    └───┴───┴───┴───┴───┴───┴───┴───┘
# y/x  0   1   2   3   4   5   6   7
# 
#    ┌───┬───┬───┬───┬───┬───┬───┬───┐
#  7 │   │   │   │   │   │   │   │   │
#    ├───┼───┼───┼───┼───┼───┼───┼───┤
#  6 │   │   │   │   │1-b│   │   │   │
#    ├───┼───┼───┼───┼───┼───┼───┼───┤
#  5 │   │   │   │   │   │   │   │   │
#    ├───┼───┼───┼───┼───┼───┼───┼───┤
#  4 │   │   │   │   │1-w│   │   │   │
#    ├───┼───┼───┼───┼───┼───┼───┼───┤
#  3 │   │   │   │   │   │   │   │   │
#    ├───┼───┼───┼───┼───┼───┼───┼───┤
#  2 │   │   │   │   │   │   │   │   │
#    ├───┼───┼───┼───┼───┼───┼───┼───┤
#  1 │   │   │   │   │   │   │   │   │
#    ├───┼───┼───┼───┼───┼───┼───┼───┤
#  0 │   │   │   │   │   │   │   │   │
#    └───┴───┴───┴───┴───┴───┴───┴───┘
# y/x  0   1   2   3   4   5   6   7
# 
#    ┌───┬───┬───┬───┬───┬───┬───┬───┐
#  7 │   │   │   │   │   │   │   │   │
#    ├───┼───┼───┼───┼───┼───┼───┼───┤
#  6 │   │   │   │   │1-b│   │   │   │
#    ├───┼───┼───┼───┼───┼───┼───┼───┤
#  5 │   │   │   │   │   │   │   │   │
#    ├───┼───┼───┼───┼───┼───┼───┼───┤
#  4 │   │   │   │1-w│   │   │   │   │
#    ├───┼───┼───┼───┼───┼───┼───┼───┤
#  3 │   │   │   │   │   │   │   │   │
#    ├───┼───┼───┼───┼───┼───┼───┼───┤
#  2 │   │   │   │   │   │   │   │   │
#    ├───┼───┼───┼───┼───┼───┼───┼───┤
#  1 │   │   │   │   │   │   │   │   │
#    ├───┼───┼───┼───┼───┼───┼───┼───┤
#  0 │   │   │   │   │   │   │   │   │
#    └───┴───┴───┴───┴───┴───┴───┴───┘
# y/x  0   1   2   3   4   5   6   7
# 
#    ┌───┬───┬───┬───┬───┬───┬───┬───┐
#  7 │   │   │   │   │   │   │   │   │
#    ├───┼───┼───┼───┼───┼───┼───┼───┤
#  6 │   │   │   │   │1-b│   │   │   │
#    ├───┼───┼───┼───┼───┼───┼───┼───┤
#  5 │   │   │   │1-w│   │   │   │   │
#    ├───┼───┼───┼───┼───┼───┼───┼───┤
#  4 │   │   │   │   │   │   │   │   │
#    ├───┼───┼───┼───┼───┼───┼───┼───┤
#  3 │   │   │   │   │   │   │   │   │
#    ├───┼───┼───┼───┼───┼───┼───┼───┤
#  2 │   │   │   │   │   │   │   │   │
#    ├───┼───┼───┼───┼───┼───┼───┼───┤
#  1 │   │   │   │   │   │   │   │   │
#    ├───┼───┼───┼───┼───┼───┼───┼───┤
#  0 │   │   │   │   │   │   │   │   │
#    └───┴───┴───┴───┴───┴───┴───┴───┘
# y/x  0   1   2   3   4   5   6   7
# 
#    ┌───┬───┬───┬───┬───┬───┬───┬───┐
#  7 │   │   │   │   │   │   │   │   │
#    ├───┼───┼───┼───┼───┼───┼───┼───┤
#  6 │   │   │   │   │   │   │   │   │
#    ├───┼───┼───┼───┼───┼───┼───┼───┤
#  5 │   │   │   │   │   │   │   │   │
#    ├───┼───┼───┼───┼───┼───┼───┼───┤
#  4 │   │   │   │   │   │   │   │   │
#    ├───┼───┼───┼───┼───┼───┼───┼───┤
#  3 │   │   │   │   │   │   │   │   │
#    ├───┼───┼───┼───┼───┼───┼───┼───┤
#  2 │   │   │   │   │   │   │   │   │
#    ├───┼───┼───┼───┼───┼───┼───┼───┤
#  1 │   │   │   │   │   │   │   │   │
#    ├───┼───┼───┼───┼───┼───┼───┼───┤
#  0 │   │   │   │   │   │   │   │   │
#    └───┴───┴───┴───┴───┴───┴───┴───┘
# y/x  0   1   2   3   4   5   6   7
White wins: no stacks left on board